Image,Prompt,Groq_Response,Groq_Time,Groq_Accuracy,Groq_Completeness,Groq_Relevance,Groq_Insight,Groq_Total,Groq_Comments,OpenAI_Response,OpenAI_Time,OpenAI_Accuracy,OpenAI_Completeness,OpenAI_Relevance,OpenAI_Insight,OpenAI_Total,OpenAI_Comments
assets/complex_street_small_1.png,Describe the scene in detail.,"The scene takes place in a small street-side cafe with a table, a chair, and an umbrella providing a shaded area. A small pumpkin decoration can be seen near the outdoor seated area. There is a woman walking with her hands at her sides with cars parked nearby. Another person can be spotted approaching the cafe.

Utensils, such as forks and spoons, are visible on the street corner. Various potted plants are found throughout the area, adding greenery to the urban setting. A number of chairs, dining tables, and benches are placed such that people can comfortably dine or relax outside. Additionally, umbrellas are placed around the cafe to offer shade during outdoor events. A car is parked in front of a building, likely belonging to a local resident.",1.740175724029541,2,4,5,3,14,"The Groq response is largely inaccurate and does not align well with the ground truth. It describes a cafe scene that is not mentioned in the ground truth, and fails to mention key elements like the intersection, traffic lights, and the prominent red brick building. While it does mention some urban elements like cars and buildings, the overall description is off-target.","The scene captures a charming street corner featuring a restaurant named ""Da Gennaro,"" which specializes in Italian cuisine. The building showcases classic red brick architecture, with large windows adorned with decorative trim. 

The entrance of the restaurant has a welcoming outdoor seating area, featuring several tables and chairs arranged beneath vibrant red umbrellas. This setup suggests a lively atmosphere, perfect for al fresco dining. Nearby, seasonal decorations like pumpkins hint at a festive fall ambiance.

The street is lined with typical urban elements: traffic lights, signposts, and fire escapes providing practicality and character to the scene. A banner advertising some offerings hangs prominently, complemented by an advertisement for Bertolli, adding to the Italian theme.

Sunlight casts gentle shadows, enhancing the warm tones of the brick and the inviting feel of the restaurant. A few patrons appear to be enjoying their time, enriching the lively urban setting. Overall, the scene exudes a blend of warmth, charm, and bustling city life.",4.938349962234497,6,8,9,7,30,"The OpenAI response is more accurate and relevant to the ground truth. It mentions the red brick building and provides a detailed description of the urban scene. While it doesn't explicitly mention the intersection or the number of cars and traffic lights, it does describe elements of an urban street setting. The response is comprehensive and offers insights into the atmosphere and details of the scene."
assets/complex_street_small_1.png,How many vehicles and traffic lights can you see?,"In the image, there is a single car parked on the street corner, with the traffic lights hanging on wires. There are 3 traffic lights visible, with 2 of them on street signs.",1.5957489013671875,5,7,8,6,26,"Groq's response is partially accurate but misses the mark on the number of vehicles. It correctly identifies 3 traffic lights, which aligns with the ground truth. However, it mentions only one car instead of seven. The response is fairly complete, addressing both vehicles and traffic lights as requested. It's highly relevant to the prompt and provides some additional details about the traffic lights' positions, showing a degree of insight.","In the image, I can see one visible vehicle and one traffic light.",3.627349853515625,3,5,8,2,18,"OpenAI's response is less accurate, identifying only one vehicle and one traffic light, which is significantly off from the ground truth of seven cars and three traffic lights. The response is minimally complete, addressing both parts of the question but lacking in detail. It's relevant to the prompt but doesn't provide any additional insights or observations beyond the bare minimum asked."
assets/complex_street_small_1.png,What's the most prominent building in the image?,"The most prominent building in the image is a restaurant located on a corner. It has a black and red awning, displaying a modernized appearance, surrounded by buildings.",1.5333871841430664,6,7,8,6,27,"Groq's response correctly identifies a prominent building as a restaurant on a corner, which aligns with the ground truth of a prominent building. However, it mentions a black and red awning, which isn't explicitly stated in the ground truth. The response is relevant to the prompt and provides some details, but lacks specific information about the building's material (red brick) mentioned in the ground truth.","The most prominent building in the image appears to be the restaurant ""Da Gennaro,"" which has distinctive signage and an outdoor dining area. Its architectural features and the signage make it the focal point of the scene.",3.9172160625457764,7,8,9,7,31,"OpenAI's response provides more specific details about the prominent building, including its name 'Da Gennaro' and the presence of an outdoor dining area. While it doesn't mention the red brick material, it does describe the building as the focal point of the scene, which aligns well with the ground truth's description of a 'prominent' building. The response is highly relevant to the prompt and offers more detailed insights about the building's features."
assets/abstract_painting.png,Describe the colors and patterns in this image.,"The image features a large, colorful painting with a sunset scene in the center, depicting sunpink rays spreading from the center. The scene also contains riotously colored undulating shapes that add to the abstract, vibrant style of the painting. This vivid work of art covers the entirety of both the foreground and background, and it is executed with deep colors that intensify the art's effects on the viewer. The entire surface of the painting is painted in pastel chilly blue hues and fiery reds, creating a striking and visually stimulating display.",2.042012929916382,6,8,9,7,30,"Groq's response accurately identifies the abstract and colorful nature of the painting, but misinterprets some elements (e.g., sunset scene, sunpink rays). It captures the vibrant colors well, mentioning blue and red tones, which aligns with the ground truth. The response is quite complete, addressing both colors and patterns as requested. It's highly relevant to the prompt, providing a detailed description. The insight score reflects its attempt to interpret the painting's style and effect on the viewer.","The image features a dynamic swirl of colors and patterns, creating a visually engaging abstract composition. 

Starting from the top, there are soft gradients of light blue that transition into deeper shades of blue as they move downward. The middle portion shifts to lighter hues, including hints of white and yellow, creating a bright focal point. 

As you move further down, these colors blend into warm tones—golden yellows and vibrant oranges—before darkening into rich reds and deeper shades at the bottom. The swirling patterns give the impression of fluid motion, with thick, wavy lines adding depth and texture. Overall, the colors transition smoothly, evoking a sense of warmth and energy.",5.270349025726318,9,9,10,8,36,"OpenAI's response aligns very closely with the ground truth, accurately describing the swirling patterns and key colors (blue, yellow, red). It provides a complete description, detailing the color transitions and patterns throughout the image. The response is perfectly relevant to the prompt, focusing entirely on colors and patterns. It offers insightful observations about the fluid motion effect and the smooth color transitions, adding depth to the description."
assets/abstract_painting.png,What emotions does this painting evoke?,"This painting, which features a red and yellow palette, primarily blue, and orange color, evokes emotions of intensity, energy, and warmth. The vibrant colors create a visually striking composition, with red and yellow tones suggesting passion and warmth, while the blues and oranges encourage tranquility and relaxation. Altogether, the painting conveys a sense of vitality and excitement – pushing you to embrace the possibilities it offers and enhancing your mood.",1.4309029579162598,8,9,10,8,35,Groq's response accurately captures the emotions evoked by the painting's colors and composition. It provides a thorough analysis of the color palette and its emotional impact. The response is highly relevant to the prompt and offers insightful observations about the painting's effect on mood and vitality.,"This painting, with its swirling patterns and vibrant colors, evokes a range of emotions. The warm reds and oranges may suggest feelings of energy, passion, or warmth, while the cooler blues can impart a sense of calm, tranquility, or depth. The dynamic movement of the waves can create a feeling of fluidity and change, potentially evoking excitement or even a sense of chaos. Overall, it can inspire feelings of awe, contemplation, and connection to nature or emotional depth.",4.362226963043213,9,10,10,9,38,"OpenAI's response demonstrates a high level of accuracy in describing the emotions evoked by the painting. It provides a comprehensive analysis of both warm and cool colors, as well as the impact of the swirling patterns. The response is entirely relevant to the prompt and offers insightful observations about the painting's connection to nature and emotional depth."
assets/abstract_painting.png,Can you identify any hidden shapes or figures in the painting?,"In the painting, there is a hidden face. At least two distinct image elements can be identified that evoke the fascinating dynamic motion of the sky and ocean, making the painting a unique and engaging artwork.",2.0745017528533936,7,8,9,8,32,"The Groq model provided a response that partially aligns with the ground truth by mentioning elements that evoke sky dynamics. However, it also claimed to see a hidden face, which is not mentioned in the ground truth. The response is quite thorough and directly addresses the prompt about hidden shapes. It offers unique observations about the painting's dynamics, showing good insight.","I can't identify specific hidden shapes or figures in the painting. However, the swirling colors and textures can evoke various interpretations depending on individual perspectives. You might notice forms or imagery that resonate with you personally.",7.059117078781128,9,7,8,6,30,"The OpenAI model's response is more cautious and aligns well with the ground truth by not claiming to see specific shapes that aren't mentioned. It acknowledges the abstract nature of the painting and the possibility of individual interpretation, which is relevant to the prompt. However, it doesn't provide as much specific insight or detail about the painting's elements."
assets/receipt.jpeg,What is the name of the business on this receipt?,The name of the business on this receipt is Ci Cler Celt Ar.,1.1547410488128662,5,8,9,0,22,"The Groq model attempted to answer the question but misread the business name. It provided a complete response to the prompt, which was relevant, but lacked accuracy. No additional insights were offered.","The name of the business on the receipt is ""Cider Cellar.""",3.0929341316223145,10,10,10,0,30,"The OpenAI model correctly identified the business name as 'Cider Cellar'. The response was accurate, complete, and directly relevant to the prompt. However, it didn't provide any additional insights beyond what was asked."
assets/receipt.jpeg,List the items purchased and their individual prices.,"The items purchased were 2 items of wine, with one being for €30.99 and the other one being for €32.49. Including these two items and taxes, the total purchase amount was €65.46.",1.469223976135254,2,6,7,1,16,"The Groq response is largely inaccurate. It incorrectly identifies the items as wine and provides wrong prices. It does attempt to list items and prices as requested, but the information is entirely incorrect. The only somewhat relevant aspect is mentioning two items, which aligns with the ground truth.","The items purchased and their individual prices are:

1. Bulmers Original Bottle - £4.00
2. Bulmers Pear Bottle - £4.00

Total before discounts: £8.00  
Total after discounts: £4.50",2.6642632484436035,9,10,10,8,37,"The OpenAI response is highly accurate, complete, and relevant. It correctly identifies both items (Bulmers Original Bottle and Bulmers Pear Bottle) and their individual prices (£4.00 each). It goes beyond the prompt by providing additional insight about the total before and after discounts, which aligns with the ground truth."
assets/receipt.jpeg,"What is the total amount paid, and were any discounts applied?","Based on the receipt shown in the image, the total amount paid is ₤15.05. The receipt is showing the same amount and does not indicate any discounts applied.",1.3625590801239014,1,5,7,2,15,"The Groq model's response was largely inaccurate. It incorrectly stated the total amount as £15.05, which is not aligned with the ground truth. It also failed to identify the applied discounts, which were a key part of the question. The response did attempt to address both parts of the prompt, showing some relevance, but lacked accuracy and insight.","The total amount paid was £4.50. 

Yes, discounts were applied: a line discount of £3.00 and a transaction discount of £0.50, totaling £3.50 in discounts.",2.4151179790496826,10,10,10,8,38,"The OpenAI model's response was highly accurate and complete. It correctly identified the total amount paid as £4.50 and accurately described the discounts applied, including specific amounts for line and transaction discounts. The response was fully relevant to the prompt and showed good insight by breaking down the discount details."
assets/natural_landscape.png,Describe the landscape in this image.,"The landscape in this image depicts a forest where various animals live, including deer, bears, and a rabbit. Three red deer are present, with one near a tree, another one in the middle of the forest, and the third one near the water. The forest trees and bushes add to the lush and natural setting. Furthermore, there is a bear sitting under the trees in the midground, while another bear sits atop a nearby hill. A mushroom is also visible in the scene, likely representing part of the flora. Although no humans are seen, the scene captures the contrasting nature of the forest's lively wildlife and the darkness of the trees near the water.",1.2234668731689453,6,8,9,7,30,"Groq's response provides a detailed description of the forest landscape, but misidentifies some animals. It correctly mentions deer and a forest setting with trees, bushes, and water. However, it incorrectly includes bears and a rabbit, which are not mentioned in the ground truth. The response is quite complete and relevant to the prompt, offering good insights about the contrast between wildlife and the darker areas near the water.","The landscape depicts a serene forest scene, filled with vibrant colors and enchanting elements. Tall trees with lush green foliage create a canopy above, allowing soft, dappled light to filter through. A meandering stream flows gently through the scene, reflecting the light and surrounded by patches of grass and wildflowers, particularly daisies.

In the foreground, a deer stands gracefully, its antlers prominent, while a curious fox observes nearby. An owl, perched on a rock, adds to the woodland atmosphere. The overall mood is calm and whimsical, characterized by the lush greenery and a sense of tranquility in the natural environment.",5.090047121047974,9,9,10,8,36,"OpenAI's response accurately describes the forest scene, correctly identifying the deer, fox, and owl mentioned in the ground truth. It also captures the presence of trees, foliage, and a stream. The description is highly complete, addressing all aspects of the landscape, and perfectly relevant to the prompt. It provides insightful observations about the lighting, atmosphere, and mood of the scene, adding depth to the description."
assets/natural_landscape.png,"Can you spot any hidden animals? If so, what are they?","Yes, there is a hidden animal in the picture. It is an owl that can be seen sitting on a tree branch next to a deer. The picture is a cartoonish deer and rabbit image that includes other elements such as a giraffe, a blue butterfly, and a snake as part of a sunflower. These various hidden animals add an engaging twist to the image, making it unique and fun to look at.",1.8376250267028809,6,7,8,5,26,"Groq correctly identified the owl and deer, but missed the fox. It also added incorrect animals like a rabbit, giraffe, butterfly, and snake, which weren't mentioned in the ground truth. The response was somewhat complete and relevant to the prompt, but lacked accuracy in some aspects.","In the image, I can spot three main animals:

1. A deer standing on the left.
2. An owl perched on a stone in the center.
3. A fox on the right.

If there are any additional hidden animals in the background or foliage, I can't make them out.",4.288206100463867,9,9,10,7,35,"OpenAI's response was highly accurate, identifying all three hidden animals correctly (deer, owl, and fox). The answer was complete, addressing the prompt fully. It showed good insight by mentioning the possibility of additional hidden animals in the background or foliage, even though it couldn't identify any more."
assets/natural_landscape.png,"What time of day does this scene appear to be set in, and why?","This scene appears to be set during either early morning or during the twilight hours, as the leaves are yellow highlighting the green forest. In the image, there are deer standing near a body of water in a forest. The green leaves and the shadows they cast contribute to the richness of the forest, making it a middling light environment where the visibility of colors and the details might be enhanced. This is also evident by the surrounding golden scenery, which evokes a sense of tranquility, calmness, and a serene atmosphere.",1.8785920143127441,7,8,9,8,32,"Groq's response accurately describes the time of day and provides good reasoning. However, it misses mentioning the owl and fox, and incorrectly states there are multiple deer.","The scene appears to be set in the early morning or late afternoon. This is suggested by the soft, warm light filtering through the trees, creating a serene atmosphere. Additionally, the presence of animals like the deer and the owl can indicate a transitional time when different species are active, such as dawn or dusk. The lush green surroundings and the blooming flowers also hint at a vibrant natural setting typical of these times of day.",4.401987075805664,9,9,10,9,37,"OpenAI's response is highly accurate, complete, and relevant. It correctly identifies all animals and provides insightful reasoning for the time of day."
